##########################
#####......###########..##
#####......###.....#..#..#
##..####....#.#...##..#..#
#.#.#..###..#....###.#.#.#
#####.##...#.#..##.#.#...#
##.!#.####....###.###..###
##.##.#...#.#.##.####.####
#..#..##.#####.###.#######
#......#..##.###....######
#....###.###.#.##.#...####
#.##....##.##.#..###.#.###
#@##.##...#.......###.##.#
##########################