##########
#....##.!#
#....##..#
#....##..#
###..#..##
#........#
####.....#
#........#
#....@...#
##########